11111111111111111111111111111111111111111111111111111111111
1E000000000000000000000000000000000000000000000000000000001
10000111110000000000000001111000000000000000000000000000001
10000000010000000000000001000000000011111000000000000000001
10000000010000000000000001000000000010001000000000000000001
10000000010000000000000001000000000010001000000111110000001
10000000011110000111110001111000000011111000000100000000001
10000000000000000000000000000000000000000000000100000000001
100000000C0000000000000000000000000000000000000100000000001
100000000000000000000011111000C0000000000000000100000000001
10000000000000000000001000000000000000000111100100000000001
10000011111000011111001000000000000000000100000100000000001
10000010001000010001001000000000000000000100000111110000001
1000001000100001000100100000000000C000000100000000000000001
10000011111000011111001000000000000000000100000000000000001
1P000000000000000000000100000000000000000001000000000000001
10000111111000000000110000000000000000000100000000000000001
10000000001000000000100000000000011111000100000000000000001
11111111111111111111111111111111111111111111111111111111111