11111111111111111111111111111111111111111111111111111111111
1E000000000000000000000000000000000000000000000000000000001
10000111110000000000000001111000000000000000000000000000001
10000000010000000000000001000000000011111000000000000000001
10000000010000000000000001000000000010001000000000000000001
10000000010000000000000001000000000010001000000111110000001
10000000011110000111110001111000000011111000000100000000001
10000000000000000000000000000000000000000000000100000000001
10000000000000000000000000000000000000000000000100000000001
10000000000000000000001111100000000000000000000100000000001
10000000000000000000001000000000000000000111100100000000001
10000011111000011111001000000000000000000100000100000000001
10000010001000010001001000000000000000000100000111110000001
10000010001000010001001000000000000000000100000000000000001
10000011111000011111001000000000000000000100000000000000001
1P000000000000000000000100000000000000000001000000000000001
10000111111000000000110000000000000000000100000000000000001
10000000001000000000100000000000011111000100000000000000001
10000000001000000000100000000000010001000100000000000000001
11111000001000001111100000000000010001000100000000000000001
10001000001000001000000000000000010001000100000000000000001
10001000001111101000000000000000011111000111110000000000001
10001000000000001000000000000000000000000000000000000000001
10001000000000001000000000000000000000000000000000000000001
10001000000000001111100000000111110000000000000000000000001
10001000000000001000000000000100000000000000000000000000001
10001111110000001000000000000100000000000000000000000000001
1000000000100000C000000000000C000000000000C0000000000000001
10000000001000000000000000000000000000000000000000000000001
1C000000001000000000000000000000000000000000000000000000001
10000000000100000000000000000000000000000000000000000000001
10000000000000000000000000000000000000000000000000000000001
11111111111111111111111111111111111111111111111111111111111